%%%%%%%%%%%%%%%%%%%%%%%%%
% P....      ....    .. %
% ..  ...  ...  ...  .. %
%     ...  ...  ...  .. %
%   ...      .... G  .. %
%     ...  ...  ...  .. %
% ..  ...  ...  ...  .. %
%  ....      ....    ..o%
%%%%%%%%%%%%%%%%%%%%%%%%%
